Familie = family
Familien = families
Straße = road
Hause = house
Garten = garden
oben; nach oben = upstairs
unten, nach unten = downstairs
Schlafzimmer = bedroom
Badezimmer = bathroom
Esszimmer = dining room
Küche = kitchen
Wohnzimmer = living room
Sessel = armchair
Bett = bed
Lampe = lamp
Regal = shelf
Regale = shelves
Sofa = sofa
Tisch = table
Spielzeug = toy
Fernseher = TV
fernsehen = watch TV
klein = small
Aufgabe = task


aufwachen = wake up
frühstücken = have breakfast
ein Teller ... = a plate of ...
Krebs = crab
nach dem Frühstück = after breakfast
nachmittags, am Nachmittag = in the afternoon
spielen = play
abends, am Abend = in the evening
Fisch = fish
Abendessen, Abendbrot = dinner
sitzen, sich setzen = sit
Fels, Felsen = rock
einem Freund eine SMS schicken = text a friend
