Frau Bell = Miss Bell
Guten Morgen. = Good morning.
also; deshalb, daher = so
hereinkommen = come in
anfangen, beginnen = start
Ball = ball
werfen = throw
fragen = ask
fangen = catch
antworten, beantworten = answer
über dich selbst = about yourself
Geburtstag = birthday
Januar = January
Februar = February
März = March
April = April
Mai = May
Juni = June
Juli = July
August = August
September = September
Oktober = October
November = November
Dezember = December
machen, tun = do
leben, wohnen = live
in der Deanstraße 14 = at 14 Dean Street
dann = then
wieder, nochmal = again
Stundenplan = timetable
Viertel nach zehn = quarter past ten
halb 11 = half past ten
Viertel vor elf = quarter to eleven
Schulfach = subject
Kunst = Art
Design und Technik = Design and Technology
Französisch = French
Geografie = Geography
Geschichte = History
Informations- und Kommunikationstechnik = ICT
Mathematik = Maths
Musik = Music
Sportunterreicht, Turnen = PE
Religion = Religion
Naturwissenschaft = Science
Stunde = hour
Mittagessen = lunch
Pause = break
lernen = learn
zweiter = second
dritter = third
vierter = forth
fünfter = fifth
wann? = when?
schreiben = write
