finden = find
Gibt es (irgendwelche) ...? = Are there any ...?
buchstabieren = spell
arbeiten = work
lesen = read
sich etwas anschauen; beobachten = watch
einschlafen = fall asleep
Ort, Platz, Stelle = place
diese Pause = this break
Ich weiß (es) nicht. = I don't know.
essen = eat
Welche Farbe ...? = What colour ...?
Kantine, (Schul-)Mensa = canteen
Turnhalle = gym
Wir sind fertig. = We're finished.
zurück = back
wir können nicht ... = we can't
gewinnen = win
ihn; ihm = him
Gewinner/in; Sieger/in = winner
Alltags- = everday
Arbeitsheft = workbook
Seite = page
Toilette = toilet
Was haben wir als Hausaufgabe auf? = What's for homework?
Hausaufgabe(n) = homework
Es gibt keine ... = There aren't any ...
auf Deutsch = in German
Chaos = chaos
Laden an der Ecke = corner shop
Meister/in = master
Joghurt = yoghurt
klein = little
immer = always
Gruppe (von) = group (of)
die Gruppe (dort); jene Gruppe = that group
schwimmen = swim
wie jungen = like boys
Schwimmer/in = swimmer
gut sein in Kung-Fu = be goot at kung fu
Gefühl = feeling
wütend = angry
glücklich, froh = happy
überrascht = surprised
vorspielen = act out
das nächste Frage = the next question
Mann = man
Männer = men
Frau = woman
Frauen = women
