Miss Bell = Frau Bell
Good morning. = Guten Morgen.
so = also; deshalb, daher
(to) come in = hereinkommen
(to) start = anfangen, beginnen
ball = Ball
(to) throw = werfen
(to) ask = fragen
(to) catch = fangen
(to) answer = antworten, beantworten
answer = Antwort
about yourself = über dich selbst
birthday = Geburtstag
January = Januar
February = Februar
March = März
April = April
May = Mai
June = Juni
July = Juli
August = August
September = September
October = Oktober
November = November
December = Dezember
(to) do = machen, tun
(to) live = leben, wohnen
at 14 Dean Street = in der Deanstraße 14
then = dann
again = wieder, noch einmal
timetable = Stundenplan
quarter past ten = Viertel nach zehn
half past ten = halb 11
quarter to eleven = Viertel vor elf
subject = Schulfach
Art = Kunst
Design and Technology = Design und Technik
French = Französisch
Geography = Geografie
History = Geschichte
ICT = Informations- und Kommunikationstechnik
Maths = Mathematik
Music = Musik
PE = Sportunterreicht, Turnen
Religion = Religion
Science = Naturwissenschaft
hour = Stunde
lunch = Mittagessen
break = Pause
(to) learn = lernen
second = zweiter
third = dritter
fourth = vierter
fifth = fünfter
when? = wann?
(to) write = schreiben
