my favourite animal = mein Lieblingstier
ant = Ameise
bear = Bär
bird = Vogel
butterfly = Schmetterling
butterflies = Schmetterlinge
cat = Katze
dog = Hund
elephant = Elefant
frog = Frosch
giraffe = Giraffe
guinea pig = Meerschweinchen
horse = Pferd
lion = Löwe
monkey = Affe
pig = Schwein
rabbit = Kaninchen
rat = Ratte
snake = Schlange
whale = Wal

an elephant = ein Elefant
picture = Bild
strange = seltsam, komisch

red = rot
yellow = gelb
blue = blau
green = grün
brown = braun
orange = orange
grey = grau
pink = pink, rosa
purple = violett, lila
white = weiß
black = schwarz

ruler = Lineal
game = Spiel
with = mit
leg = Bein
without = ohne
now = nun, jetzt
time = Zeit, Uhrzeit
for = für
English = Englisch
lesson = (Unterrichts-) Stunde
