our = unser/e
class = (Schul-) Klasse
Mr Schwarz = Herr Schwarz
Mrs Schwarz = Frau Schwarz
teacher = Lehrer/in
school = Schule
word = Wort
classroom = Klassenzimmer
cupboard = Schrank
desk = Schreibtisch
thing = Sache, Ding
rubber = Radiergummi
pen = Kugelschreiber, Stift, Füller
board = Tafel
chair = Stuhl
clock = Standuhr
watch = Armbanduhr
door = Tür
window = Fenster
This is ... = Dies ist .../Das ist ...
school bag = Schultasche
book = Buch
exercise book = Schulheft, Übungsheft
pencil = Bleistift
pencil case = Federmäppchen
glue stick = Klebestift
glue = Klebstoff
sharpener = Anspitzer
Let me show you ... = Lass mich dir ... zeigen
show = zeigen
Simon says ... = Simon sagt ...
put = legen, stellen
talk = reden
open = öffnen, aufmachen
touch = berühren
give = geben

fifteen = 15
sixteen = 16
seventeen = 17
eighteen = 18
nineteen = 19
twenty = 20
twenty-one = 21
thirty = 30
forty = 40
fifty = 50
sixty = 60
seventy = 70
eighty = 80
ninety = 90
a hundred = 100

count = zählen
them = sie, ihnen
telephone = Telefon
double = Doppel-
See you. = Bis gleich. / Bis bald.
