before school = vor der Schule (vor Schulbeginn)
before lessons = vor dem Unterricht
you aren't ... = du bist nicht ...
there = da, dort; dahin, dorthin
sad = traurig
Don't go. = Geh nicht.
Bye. = Tschüs.
Watch out! = Pass auf! / Vorsicht!
(I'm) sorry. = Tut mir leid. /Entschuldigung.
So? = Und? / Na und?
Nice to meet you. = Freut mich, dich/euch/Sie kennenzulernen.
hurry up = sich beeilen
who? = wer?
friendly = freundlich
shoe = Schuh
trainer = Turnschuh
forget = vergessen
wear = tragen (Kleidung)
British = britisch
different = verschieden, anders
have = haben
I don't like green. = Ich mag grün nicht. / Ich mag kein grün.
Have a go. = Versuch's mal.
language = Sprache
form (of) = Form (von)
of = von
long = lang
short = kurz
people = Leute, Menschen
silly = albern, blöd
sentence = Satz
help = Hilfe
help = helfen
speaker = Sprecher/in
about me = über mich
at 1 o'clock = um 1 Uhr/um 13 Uhr
appointment = Verabredung, Termin
