(to) find = finden
Are there any ...? = Gibt es (irgendwelche) ...?
(to) spell = buchstabieren
(to) work = arbeiten
(to) read = lesen
(to) watch = sich etwas anschauen; beobachten
(to) fall asleep = einschlafen
place = Ort, Platz, Stelle
this break = diese Pause
this subject = dieses Fach
I don't know. = Ich weiß (es) nicht.
(to) eat = essen
What colour ...? = Welche Farbe ...?
canteen = Kantine, (Schul-)Mensa
gym = Turnhalle
We're finished. = Wir sind fertig.
back = zurück
we can't = wir können nicht ...
(to) win = gewinnen
him = ihn; ihm
winner = Gewinner/in; Sieger/in
everday = Alltags-
workbook = Arbeitsheft
page = Seite
toilet = Toilette
What's for homework? = Was haben wir als Hausaufgabe auf?
homework = Hausaufgabe(n)
There aren't any ... = Es gibt keine ...
in German = auf Deutsch


chaos = Chaos
corner shop = Laden an der Ecke
master = Meister/in
yoghurt = Joghurt
little = klein
always = immer
group (of) = Gruppe (von)
that group = die Gruppe (dort); jene Gruppe
(to) swim = schwimmen
like boys = wie jungen
swimmer = Schwimmer/in
(to) be goot at kung fu = gut sein in Kung-Fu
feeling = Gefühl
angry = wütend
happy = glücklich, froh
surprised = überrascht
(to) act out = vorspielen
the next question = das nächste Frage
man = Mann
men = Männer
woman = Frau
women = Frauen
