family = Familie
families = Familien
road = Straße
house = Hause
garden = Garten
upstairs = oben; nach oben
downstairs = unten, nach unten
bedroom = Schlafzimmer
bathroom = Badezimmer
dining room = Esszimmer
kitchen = Küche
living room = Wohnzimmer
armchair = Sessel
bed = Bett
lamp = Lampe
shelf = Regal
shelves = Regale
sofa = Sofa
table = Tisch
toy = Spielzeug
TV = Fernseher
watch TV = fernsehen
small = klein
task = Aufgabe


wake up = aufwachen
have breakfast = frühstücken
a plate of ... = ein Teller ...
crab = Krebs
after breakfast = nach dem Frühstück
in the afternoon = nachmittags, am Nachmittag
play = spielen
in the evening = abends, am Abend
fish = Fisch
dinner = Abendessen, Abendbrot
sit = sitzen, sich setzen
rock = Fels, Felsen
text a friend = einem Freund eine SMS schicken
