her = sie; ihr
go sailing = segeln; segeln gehen
into the kitchen = in die Küche
make = machen; herstellen
a cup of ... = eine Tasse
tea = Tee
paper = Zeitung
at the weekend = am Wochenende
at night = nachts; in der Nachts
sleep = schlafen
feed = füttern
no ... = kein ..., keine ...
us = uns
of course = natürlich, selbstverständlich
basket = Korb
floor = Fußboden
trophy = Pokal; Trophäe
trophies = Pokale, Trophäen
away = weg, fort
mad = verrückt
think = denken, glauben
so cool/nice ... = so cool/nett ...
go for a walk = einen Spaziergang machen, spazieren gehen
pronounciation = Aussprache
run = rennen, laufen

uncle = Onkel
aunt = Tante
sport = Sport; Sportart
do sport = Sport treiben
near here = (hier) in der Nähe
he doesn't have time = er hat keine Zeit
only = nur, bloß
often = oft
tell (about) = erzählen (von); berichten (über)
all = alles; alle
..., you know. = ..., weißt du/... wissen Sie.
cousin = Cousin, Cousine
person = Person
grandma = Oma
farm = Bauernhof
Well, ... = Nun, ... / Also, ... / Na ja ...
till 12 o'clock = bis 12 Uhr
family tree = (Familien-)Stammbaum
tree = Baum
dead = tot
divorced = geschieden
married (to) = verheiratet (mit)
single = ledig, alleinstehend
twins = Zwillinge
