What's for lunch? = Was gibt es zum Mittagessen?
roast beef = Rinderbraten
potato = Kartoffel
potatoes = Kartoffeln
yummy = lecker
vegetables = Gemüse
soup = Suppe
dessert = Nachtisch, Nachspeise
fruit salad = Obstsalat
ice cream = (Speise-) Eis
scone = kleines rundes Milchbrötchen
(to) take = nehmen, mitnehmen
on the radio = im Radio
in the middle = in der Mitte
What would you like? = Was hättest du gern? / Was möchstest du?
I'd like ... = Ich hätte gerne ... / Ich möchte ...
What would you like to eat? = Was möchtest du essen?
hot = heiß
cold = kalt
(to) drink = trinken
drink = Getränk
sandwich = Sandwich / belegtes Brot
cake = Kuchen
cream = Sahne
jam = Marmelade
food = Essen; Lebensmittel; Futter
biscuit = Keks, Plätzchen
bread = Brot
cheese = Käse
meat = Fleisch
milk = Milch
water = Wasser

