sound = Geräusch, Klang
attic = Dachboden
boring = langweilig
mouth = Mund, Maul
diary = Tagebuch, Kalender
diaries = Tagebücher
address = Adresse, Anschrift
sick = krank
(to) hope = hoffen
bottle = Flasche
(to) smell = riechen
Me too. = Ich auch.
out of ... = aus ... (heraus/hinaus)
(to) call = rufen, anrufen, rennen
moon = Mond
(to) walk = (zu Fuß) gehen
along the street = die Straße entlang
along the river = den Fluß entlang
Oh, it's you. = Ach, du bist es.
(to) bark = bellen
step = Schritt
voice = Stimme
thief = Dieb(in
thieves = Diebe
hand = Hand
(to) fight = kämpfen
coin = Münze
(to) taste = schmecken
end = Ende, Schluß
dream = Traum
perfect = perfekt, ideal
(to) understand = verstehen

