(to) smile = lächeln
bite, bit = beißen (simple past)
just = (einfach) nur; bloß
We couldn't go back. = Wir konnten nicht zurückgehen.
bell = Klingel, Glocke
(to) weigh = wiegen
kilogram = Kilogramm
kilo = Kilo
spot = Fleck, Punkt
hard = schwer, schwierig, hart
leave, left = verlassen (simple past)
kilometre = Kilometer
(to) practise = üben, trainieren
holidays = Ferien
many = viele
orange = Orange; Apfelsiene
worm = Wurm
news = Nachrichten
paragraph = Absatz (in einem Text)
title = Titel, Überschrift
drawing = Zeichnung
caption = Bildunterschrift
order = Reihenfolge
(to) think of sth = sich etwas ausdenken; an etwas denken
another = ein(e) andere(r; s); noch ein(e)
(to) arrange = anordnen
What is the story about? = Wovon handelt die Geschichte? / Worum geht es in der Geschichte?
(to) go with sth = zu etwas passen; zu etwas gehören
buy, bought = kaufen (simple past)
enough = genug
