on Saturday afternoon = am Samstagnachmittag
(to) ride a bike = Rad fahren
bike = Fahrrad
(to) stop = anhalten, stoppen
tired = müde
(to) be thirsty = durstig sein, Durst haben
chocolate = Schokolade
usually = meistens, normalerweise, gewöhnlich
(to) turn sth on = etwas einschalten
all of Plymouth = ganz Plymouth / das ganze Plymouth
behind = hinter
in front of = vor
(to) turn around = sich umdrehen
ghost = Geist, Gespenst
ready = bereit, fertig
loud = laut
scary = unheimlich, gruselig
traveller = Reisende(r)
(to) travel = reisen
part = Teil
(to) be called = heißen, genannt werden
over 400 years = über 400 Jahre; mehr als 400 Jahre
museum = Museum
money = Geld
child = Kind
children = Kinder
ticket = Eintrittskarte
pound = Pfund (britische Währung)
(to) imagine sth = sich etwas vorstellen
life = Leben
in 1580 = im Jahr 1580

