the first day = der erste Tag
at school = in der Schule
kid = Kind, Jugendlicher
her best friend = ihr bester Freund/ihre beste Freundin
they're ... = sie sind ...
flat = Wohnung
their first day = ihr erster Tag
new = neu
uniform = (Schul-) Uniform
nice = nett, schön
too = auch
(to) know = wissen, kennen
brother = Bruder
sister = Schwester
student = Schüler/in; Student/in
but = aber
he/she/it isn't ... = er/sie/es ist nicht ...
his mum = seine Mama
mum = Mama, Mutti
mother = Mutter
dad = Papa, Vati
father = Vater
navy = Marine
(to) look at = anschauen, ansehen
dark = dunkel
Thank you. = Danke.
please = bitte
You're late. = Du bist spät dran. / Du bist zu spät.
(to) wait (for) = warten (auf)
minute = Minute
What time is it? = Wie spät ist es?
profile = Profil, Beschreibung, Portrait
library = Bibliothek
home = Heim, Zuhause
