Bonjour! = Guten Tag!
Paris = Paris
et = und
Viens! = Komm!
papa = Papa
vite = schnell
Ça va? = Wie geht's?
Miaou! = Miau!
Ouah, ouah! = Wau, wau!
S.P.A. = die S.P.A.
Ça va? = Wie geht's?
je m'appelle = ich heiße
Qui est-ce? = Wer ist das?
Attention! = Achtung! / Vorsicht!
non = nein
Pardon. = Entschuldigung.
Salut! = Hallo/Grüß dich!
comment? = wie?
Tu t'appelles comment? = Wie heißt du?
c'est = das ist
moi = ich
je suis = ich bin
toi = du

voilà = da ist, da sind
bizarre = komisch, merkwürdig
un chat = eine Katze
un chien = ein Hund
mais = aber
oui = ja
bien = gut
merci = danke
ici = hier, hierher
tu es = du bist
de = von, aus
aussi = auch
