Willkommen! = Bienvenue!
Hallo/Grüß dich! = Salut!
ich heiße = je m'applle
und = et
du = toi
ich = moi
Wie geht's? = Ça va?
ja = oui
danke = merci
Bis später! = A plus!
Guten Tag! = Bonjour!
gut = bien
Auf Wiedersehen = Au revoir!
Tschüß = Salut!
ein Freund = un ami
eine Freundin = une amie
Guten Tag, Freunde! = Bonjour, les amis!
ein Lied = une chanson
Kommt! = Venez!
in, nach = à
ein Freund = un copain
eine Freundin = une copine
bis morgen = à demain
da ist, da sind = voilà
ein Kuss, ein Küsschen = une bise
für = pour
auch = aussi
Was? = Quoi?
Ich krieg die Krise = Je pique une crise!
schnell = vite
Ruf die Polizei = Appelle la police!
kein Nachtisch = pas de dessert
in der Wüste = dans le désert
ein Bonbon = un bonbon
das ist gut = c'est bon
ein Croissant = un croissant
ein Ball = un ballon
ein Kaninchen = un lapin
ein Vulkan = un volcan
eine Hand = une main
ein Hund = un chien
ein Bleistift = un crayon
ein Elefant = un éléphant
ein Kind = un enfant
ein Haus = une maison
ein Auflauf = un gratin
mein kleines Kätzchen = mon petit chat
auf der Straße = dans la rue
ein Zeitschriften- und Schreibwarengeschäft = une maison de la presse
ein Postamt = un bureau de poste
eine Apotheke = une pharmacie
ein Kino = un cinéma
ein Park = un parc
eine Bäckerei = une boulangerie
ein Café = un café
eine Mediathek = une médiathèque
ein Restaurant = un restaurant

