mais = aber
aussi = auch
moi aussi = ich auch
toi aussi = du auch
voilà = da ist, da sind
un magasin = ein Geschäft, ein Laden
un journal = eine Zeitung
une BD = ein Comic
une affiche = ein Plakat, ein Poster
Qu'est-ce que c'est? = Was ist das?
à (Paris) = in, nach (Paris)
une maison = ein Haus
une maison de la presse = ein Zeitschriften- und Schreibwarengeschäft
Que fait Léo? = Was macht Léo?
regarder qc = etwas ansehen, etwas betrachten
parler = sprechen
avec = mit
arriver = (an)kommen
chercher qn/qc = jemanden/etwas suchen
français = französisch
en français = auf Französisch
un stylo = ein Füller, ein Kuli
une gomme = ein Radiergummi
un livre = ein Buch
un cahier = ein Heft
un crayon = ein Bleistift
un truc = ein Ding, eine Sache
écouter qn/qc = jemandem zuhören, etwas anhören
trouver qn/qc = jemanden/etwas finden
porter qc = etwas tragen
travailler = arbeiten
