un anniversaire = ein Geburtstag
une idée = eine Idee
des = plural von 'un'
un livre = ein Buch
des livre = Bücher
un cadeau = ein Geschenk
la FNAC = die FNAC
bientôt = bald
Ah, bon? = Ach ja? / Wirklich?
ensemble = gemeinsam, zusammen
une histoire = eine Geschichte
ou = oder
un ordinateur = ein Computer
un CD = eine CD / CDs
il y a = es gibt, es ist, es sind
d'abord = zuerst
bien sûr = sicherlich / na klar / selbstverständlich
Qu'est-ce qu'il y a? = Was gibt es?
préparer qc = etwas vorbereiten
la France = Frankreich
l'Allemagne = Deutschland
en Allemagne = in Deutschland
Allô? = Hallo? (am Telefon)
un train = ein Zug
Cologne = Köln
demain = morgen
ton / ta / tes = dein / deine
mon / ma / mes = mein / meine
C'est dommage. = Das ist schade.
inviter qn = jemanden einladen
allemand = deutsch
en allemand = auf Deutsch
A bientôt! = Bis bald!
maman = Mama, Mutti
une bougie = eine Kerze
un gâteau = ein Kuchen
des gâteaux = (mehrere) Kuchen
aujourd'hui = heute
ranger qc = etwas aufräumen
une chambre = ein (Schlaf-) Zimmer
s'il te plait = bitte (wenn man jemand duzt)
maintenant = jetzt
une affaire = eine Sache, eine Angelegenheit
toujours = immer
une famille = eine Familie
un enfant = ein Kind
son / sa / ses = sein / seine; ihr / ihre
C'est ça? = Stimmt's?
avoir = haben
encore = noch
un DVD = eine DVD
un jeu = ein Spiel
des jeux = Spiele
un jeu de vidéo = ein Computerspiel
des jeux vidéo = Computerspiele
avoir faim = Hunger haben
manger qc = etwas essen
souffler qc = etwas ausblasen
puis = dann
chanter = singen
avoir onze ans = elf Jahre alt sein
avoir envie de faire qc = Lust haben, etwas zu tun
sur = auf, über
une surprise = eine Überraschung
un mois = ein Monat
une année = ein Jahr
quand = wann
le premier = der erste
l'âge = das Alter
il s'appelle = er heißt

treize = 13
quatorze = 14
quinze = 15
seize = 16
dix-sept = 17
dix-huit = 18
dix-neuf = 19
vingt = 20
vingt-et-un = 21
vingt-deux = 22
vingt-trois = 23
vingt-quatre = 24
vingt-cinq = 25
vingt-six = 26
vingt-sept = 27
vingt-huit = 28
vingt-neuf = 29
trente = 30
trente-et-un = 31
trente-deux = 32
trente-trois = 33
trente-quatre = 34
trente-cinq = 35
trente-six = 36
trente-sept = 37
trente-huit = 38
trente-neuf = 39

janvier = Januar
février = Februar
mars = März
avril = April
mai = Mai
juin = Juni
juillet = Juli
août = August
septembre = September
octobre = Oktober
novembere = November
décembre = Dezember
